XXXXXXXXXXXXXXXXXXXXXXXXX
XDPPPPPPPPPPXPPPPPPPPPPDX
XPXXXXPXXXXPXPXXXXPXXXXPX
XPPPPPPPPPPPPPPPPPPPPPPPX
XPXXXXPXXXXPXPXXXXPXXXXPX
XPPPPPPPPPPPXPPPPPPPPPPPX
XXXXPXXXPXXXXXXXPXXXPXXXX
XPPPPPPPPPX   XPPPPPPPPPX
XPXXXPXXXPP   PPXXXPXXXPX
XPPPPPPPPPX   XPPPPPPPPPX
XXXXPXXXPXXXXXXXPXXXPXXXX
XPPPPPPPPPPPXPPPPPPPPPPPX
XPXXXXPXXXXPXPXXXXPXXXXPX
XPPPPPPPPPPPSPPPPPPPPPPPX
XPXXPXXXXXXPXPXXXXXXPXXPX
XDPPPPPPPPPPXPPPPPPPPPPDX
XXXXXXXXXXXXXXXXXXXXXXXXX